"filename", "language", "C++", "Makefile", "C", "Markdown", "comment", "blank", "total"
"d:\CodeProject\homework\dataStructure\CAnalyse\Makefile", "Makefile", 0, 17, 0, 0, 0, 6, 23
"d:\CodeProject\homework\dataStructure\CAnalyse\concept.md", "Markdown", 0, 0, 0, 10, 7, 6, 23
"d:\CodeProject\homework\dataStructure\CAnalyse\inc\AddressParser.hpp", "C++", 19, 0, 0, 0, 11, 15, 45
"d:\CodeProject\homework\dataStructure\CAnalyse\inc\FileReader.hpp", "C++", 15, 0, 0, 0, 11, 10, 36
"d:\CodeProject\homework\dataStructure\CAnalyse\inc\Interpreter.hpp", "C++", 24, 0, 0, 0, 0, 9, 33
"d:\CodeProject\homework\dataStructure\CAnalyse\inc\Lexer.hpp", "C++", 22, 0, 0, 0, 8, 14, 44
"d:\CodeProject\homework\dataStructure\CAnalyse\inc\Parser.hpp", "C++", 15, 0, 0, 0, 2, 8, 25
"d:\CodeProject\homework\dataStructure\CAnalyse\inc\Token.hpp", "C++", 25, 0, 0, 0, 2, 13, 40
"d:\CodeProject\homework\dataStructure\CAnalyse\readme.md", "Markdown", 0, 0, 0, 30, 7, 14, 51
"d:\CodeProject\homework\dataStructure\CAnalyse\src\AddressParser.cpp", "C++", 64, 0, 0, 0, 21, 33, 118
"d:\CodeProject\homework\dataStructure\CAnalyse\src\FileReader.cpp", "C++", 40, 0, 0, 0, 10, 20, 70
"d:\CodeProject\homework\dataStructure\CAnalyse\src\GNU\getExecDirectory.cpp", "C++", 19, 0, 0, 0, 9, 12, 40
"d:\CodeProject\homework\dataStructure\CAnalyse\src\GNU\isAbsPath.cpp", "C++", 9, 0, 0, 0, 7, 6, 22
"d:\CodeProject\homework\dataStructure\CAnalyse\src\Interpreter.cpp", "C++", 224, 0, 0, 0, 10, 46, 280
"d:\CodeProject\homework\dataStructure\CAnalyse\src\Lexer.cpp", "C++", 98, 0, 0, 0, 5, 15, 118
"d:\CodeProject\homework\dataStructure\CAnalyse\src\Parser.cpp", "C++", 26, 0, 0, 0, 1, 16, 43
"d:\CodeProject\homework\dataStructure\CAnalyse\src\Token.cpp", "C++", 46, 0, 0, 0, 0, 6, 52
"d:\CodeProject\homework\dataStructure\CAnalyse\src\main.cpp", "C++", 77, 0, 0, 0, 4, 24, 105
"d:\CodeProject\homework\dataStructure\CAnalyse\src\win\getExecDirectory.cpp", "C++", 20, 0, 0, 0, 9, 10, 39
"d:\CodeProject\homework\dataStructure\CAnalyse\src\win\isAbsPath.cpp", "C++", 10, 0, 0, 0, 7, 4, 21
"d:\CodeProject\homework\dataStructure\CAnalyse\test.c", "C", 0, 0, 1, 0, 0, 0, 1
"d:\CodeProject\homework\dataStructure\CAnalyse\test2.c", "C", 0, 0, 15, 0, 5, 9, 29
"Total", "-", 753, 17, 16, 40, 136, 296, 1258